NO ./xpm/door.xpm
SO ./xpm/newall.xpm
WE ./xpm/odoor.xpm
EA ./xpm/roolf.xpm

F 220,100,0
C 30,230,0

11111
10001
10001
10N011111
1000000001
1000000001
111111111
