NO ./xpm/door.xpm
SO ./xpm/newall.xpm
WE ./xpm/odoor.xpm
EA ./xpm/roolf.xpm

F 220,100,0
C 30,230,0

11111
10101
10101
10E01
10101
10001
11111
