NO ./xpm/door.xpm
SO ./xpm/newall.xpm
WE ./xpm/odoor.xpm
EA ./xpm/roolf.xpm

F 220,100,0
C 30,230,0

11111
10001
10001
10N01111111111111111111111111111111111111111111111111111111111111111111111111111111111111111111111111111111111111111111111111111111
100000000000000000000000100000000000000000000000000000000000000000100000000000000000000000000001
100000000000000000000000010000000000100000000000000000000000000000000000000000000001000000000001
100000000000000000000100000000000000000000000000000000000000000000100000000000001000000000000001
100000000000000000000100000000000001000000000000000000000000100000000000000000000000000000000001
100000000000000000000000000000000000000000000000000000010000000001000000000000010000000000000001
100000000000000000000000000000000000000000000000000000000000000000000000000000000000100000000001
100000000000000000000000000000000001000000000000000000000000000000000000000000000000000000000001
100000000000000000000000000000000001000000000000000000000000000000000000000000000000000000000001
111111111111111111111111111111111111111111111111111111111111111111111111111111111111111111111111111111111111111111111111111111111111
