111111111111111111111
100000001000000010001
101110101011111111101
101000101000000000101
101111111011101111101
100010100000101010001
101110111011111011101
100000000000001000001
101110100N00011110111
101010100000000010001
111011101010111010111
100000101010100010001
111010111111101110101
101010101010100000101
101011101010101010101
101010100000101010101
101010111011111011101
100010100000100010101
101010101110111010101
101000001000000000101
111111111111111111111
